2,100,1,LSM04L05,SELV0120,SELV0130,CAT_23,CIT_01&SCIT_01,60,4,0,0,0,0,0,0
0,2,1,0,1,0,0,1,0,0,0,1,0,1,1,0
0,2,1,0,1,0,0,1,0,0,0,1,0,1,0,0
,,,,,,,,,,,,,,,
0,3,0,0,4,0,0,3,0,1,2,0,0,0,0,0
0,3,0,0,4,0,0,3,0,1,0,0,0,0,0,0
,,,,,,,,,,,,,,,
0,3,0,0,4,0,0,3,0,1,2,0,0,0,0,0
0,3,0,0,4,0,0,3,0,1,0,0,0,0,0,0
,,,,,,,,,,,,,,,
0,2,1,0,1,0,0,0,0,2,1,0,1,0,0,0
0,2,1,0,1,0,0,1,0,0,0,0,0,0,0,0
,,,,,,,,,,,,,,,
0,2,1,0,1,0,0,0,0,2,1,0,1,0,0,0
0,2,1,0,1,0,0,1,0,0,0,0,0,0,0,0
,,,,,,,,,,,,,,,
0,0,0,0,0,3,0,0,0,3,0,2,0,1,0,4
0,0,0,0,0,4,0,6,0,0,0,0,0,4,0,3
,,,,,,,,,,,,,,,
0,0,0,0,0,3,0,0,0,3,0,2,0,1,0,4
0,0,0,0,0,4,0,6,0,0,0,0,0,4,0,3
,,,,,,,,,,,,,,,
0,1,0,1,0,0,0,1,0,2,0,1,0,2,0,1
0,1,0,1,0,0,0,1,0,2,0,1,0,4,0,3
,,,,,,,,,,,,,,,
0,1,0,1,0,0,0,1,0,2,0,1,0,2,0,1
0,1,0,1,0,0,0,1,0,2,0,1,0,4,0,3
,,,,,,,,,,,,,,,
0,1,0,1,0,0,0,1,0,2,0,1,0,2,0,1
0,1,0,1,0,0,0,1,0,2,0,1,0,4,0,3
,,,,,,,,,,,,,,,
0,1,0,1,0,0,0,1,0,2,0,1,0,2,0,1
0,1,0,1,0,0,0,1,0,5,7,7,7,7,7,8
,,,,,,,,,,,,,,,
0,0,0,0,0,0,0,0,0,0,0,0,0,3,2,1
0,4,0,1,0,2,0,3,0,3,0,0,0,2,0,3
,,,,,,,,,,,,,,,
0,0,0,0,0,0,0,0,0,0,0,0,0,3,2,1
0,4,0,1,0,2,0,3,0,3,0,0,0,2,0,3
